21 21
#####################
#           #    *   
# ##### ##### ### ###
# #   # #       #   #
# # # # # ######### #
#   # #       #     #
############### ### #
#               #   #
# ############### ###
#       # #  ^ *  # #
####### # # ####### #
#       # #       # #
# ####### ####### # #
#     #    @   @#  @#
##### # ##### ##### #
#*  # # # #@ *#   # #
# ##### # # ### # # #
#     # # #     #   #
# # ### # ###########
# #              @  #
#####################

