21 21
#####################
#        @  #       #
# ### # ##### ### # #
# #   # #   # # # # #
### ##### # # # # # #
#   #     #  *# # # #
# ### ######### # # #
#  *  #   #     # # #
##### # # ### ### # #
#   #   # #  *#   # #
# # ##### # # # #####
# #   #     # #     #
# ### ####### ##### #
# #     #   # #   # #
# ##### # # # # # # #
# #  @#@  # #  ^# # #
# # # ##### ####### #
#   #  *# #         #
# ##### # ######### #
# #     #  @         
#####################

