21 21
#####################
#       #   #    *   
##### # # # # ### # #
#     # # #   #   # #
# ##### ####### ### #
# #    @ *    #   # #
# ########### # # # #
#     #^      # # # #
##### ### ####### # #
#   #   #   #     #*#
# ##### ### # ##### #
# #*    #     #   # #
# # ########### ### #
# #       #     #   #
# ####### # ### # ###
# #   # # #@#   # # #
# # # # # # ##### # #
#   # #   #  @#   # #
# ### ##### # # ### #
#   #      @#       #
#####################

