21 21
#####################
#      @#         # #
### ### ### ##### # #
#   #       #   # # #
# ########### # # # #
#       # #   #  *# #
# ##### # # ####### #
# #     #         # #
# # ############# # #
# #*            #   #
########### ### ### #
#         #   #   # #
# ####### ### ### # #
#   #   #@# #@#*# # #
### # # # # # # # # #
#   # #   # # #^# # #
##### ##### # # # # #
#   #  *#       # #@#
# ##### ######### # #
#            @    # #
##### ###############

