21 21
# ###################
#     #      *#     #
# ##### ### # # # # #
#      @  # # # # # #
########### # ### # #
#      @    #     #*#
################### #
#     #           # #
# # ### ### ##### # #
# #   #   # #     # #
# ### ### # ####### #
# #   #   #*#     # #
# # ### ### # ### # #
# #   # #   # #@^ #*#
# ### # # ### # ### #
# # #  @# #   #   # #
# # ##### # ##### # #
#   # #   #     # # #
### # # ####### # # #
#    @#         #   #
#####################

