21 21
#####################
# #*      #         #
# # ### # ### ##### #
#  @#   #   #     # #
##### ##### ##### # #
#*    #  @#       # #
# ##### ########### #
#   #   #       #  @#
#^# # ### # ##### ###
# # #     # #   #   #
### # ##### # # ### #
    #     #   #     #
# # ############### #
# # #   #     #   # #
# # # ### ### # # ###
# # #     #   # #   #
# ######### ### ### #
#     #  *#     #*# #
# # ### # ####### # #
# #     #@     @    #
#####################

