21 21
#####################
#   #       #   #   #
### # ##### # # ### #
#   #     #   #@#   #
# ####### ####### ###
# #     # #   #  @  #
# # ### # # ### ###^#
# # # #   #     #   #
# # # ##### ##### # #
# #*   *#     #   # #
# ##### # ##### ### #
#   #   # #     # # #
# # # ##### ##### # #
# # #    *  #   # # #
# # ######### # # # #
# #   #  @    #   # #
# # ### ### ####### #
# #     #@# #*       
# ####### # # #######
#         #  @      #
#####################

