21 21
#####################
#           #       #
# ### ##### # ##### #
#   #     # # #   # #
#######^# # # ### # #
#@    # # #   #   #*#
# ### ### ##### ### #
# #   #   #   #     #
# # ### ### # # #####
  #     # # # #    *#
# ####### # # ##### #
# #       # #     # #
# ### # ### ##### # #
#   # #     # #   # #
# # # ####### # ### #
#*# # #*    # #     #
### # # ### # #######
# # #   # #@  #   # #
# # ##### ### # # # #
#@  #    @      #   #
#####################

